11111111111111
10000000C00P11
10C00111110011
10010000C00011
10010000100011
10001111101111
1C01100E000C11
11111111111111